NO ./path_to_the_north_texture
SO ./path_to_the_south_texture
WE ./path_to_the_west_texture
EA ./path_to_the_east_texture


F 220,100,0
C 225,30,0


       
111111111111111111 1111111111
10000000001100000111011111111
11110111111111011100000000001
11110111111111011101010010001
11000000110101011100000010011
10000000000000001100000010011
10000000000000001101010010011
11000001110101011111011110N01
11110111111101011101111010001
11111111111111111111111111111


